ALARM	AH L AA R M
BRIGHTNESS	B R AY T N AH S
BROWSER	B R AW Z ER
CAMERAS	K AE M ER AH Z
CAMERAS(2)	K AE M R AH Z
CHECK	CH EH K
CLOSE	K L OW S
CLOSE(2)	K L OW Z
CONNECTED	K AH N EH K T IH D
DECREASE	D IH K R IY S
DECREASE(2)	D IY K R IY S
DEFAULT	D IH F AO L T
EMAIL	IY M EY L
EVENTS	IH V EH N T S
EVENTS(2)	IY V EH N T S
HISTORY	HH IH S T ER IY
HISTORY(2)	HH IH S T R IY
INCREASE	IH N K R IY S
IS	IH Z
ITUNES	AY T UW N Z
JOKE	JH OW K
LIGHTS	L AY T S
LOGS	L AO G Z
MEESEEKS	M IY S IY K S
MISTER	M IH S T ER
MODE	M OW D
MUSIC	M Y UW Z IH K
NEXT	N EH K S T
NEXT(2)	N EH K S
OFF	AO F
ON	AA N
ON(2)	AO N
OPEN	OW P AH N
PARTY	P AA R T IY
PLAY	P L EY
PLAYER	P L EY ER
PREVIOUS	P R IY V IY AH S
QUIET	K W AY AH T
QUIT	K W IH T
REMOVE	R IY M UW V
SEARCH	S ER CH
SEE	S IY
SEND	S EH N D
SET	S EH T
SHOW	SH OW
START	S T AA R T
STOP	S T AA P
TERMINAL	T ER M AH N AH L
THE	DH AH
THE(2)	DH IY
TIMER	T AY M ER
TRAFFIC	T R AE F IH K
TRASH	T R AE SH
TURN	T ER N
VOLUME	V AA L Y UW M
WEATHER	W EH DH ER
WEB	W EH B
WHERE	W EH R
WHERE(2)	HH W EH R
WHO	HH UW
